16,4,2,10,11,12
17,1,1
2,2,1,2
3,8,1,2,3,4,5,6,8,9
4,8,1,2,3,4,5,6,8,9
5,8,1,2,3,4,5,6,8,9
1,2,1,2
8,6,3,4,5,6,8,9
9,7,3,4,5,6,7,8,9
7,6,3,4,5,6,8,9
20,3,13,15,16
